__IIIIIII_
IPPPPPPPP_
IPPPPPPPPI
IPPIIIIPPI
IPPII_IPPI
IPPPPPPPPI
IP__PP__PI
_PPPPPPPPI
_III_III__
